77777777770000000000000
70000000070000000000000
70000000070000000000000
70000000070000000000000
77777077770000000000000
00000000000000000000000
00000000011100000000000
00000000012100000000000
00000000011100000000000
00000000000000000000000